aback	abandonment	abash	abate
abatement	abbreviate	abdicate	abdomen
abdominal	abduct	abduction	aberrant
aberration	abet	abhor	abide
abiding	abject	ablaze	able-bodied
abolition	abolitionist	abomination	aboriginal
abound	abrasion	abrasive	abreast
abrupt	abscess	absentee	absently
absolve	absorption	abstain	abstinence
abstinent	abusive	abut	abysmal
abyss	academia	accede	accentuate
acceptability	accession	accessory	accidental
acclaim	accolade	accomodation	accompaniment
accomplice	accomplished	accord	accordance
accordion	accost	accountability	accountable
accredit	accreditation	accredited	accretion
accrue	acculturation	accusation	accuser
achiever	acidic	acidity	acknowledge
acknowledgement	acne	acorn	acquaint
acquaintance	acquiesce	acquire	acquit
acquittal	acreage	acrid	acronym
acrylic	activism	actuator	acuity
acumen	acupuncture	acute	acutely
adage	adamantly	adaptation	addictive
additive	adept	adequacy	ADHD
adhere	adherence	adherent	adhesive
adjective	adjoining	adjourn	adjudicate
adjunct	adjuster	admirable	admiration
admittedly	admonish	admonition	adolescence
adolescent	adoptive	adorable	adore
adorn	adornment	adrenaline	adrift
adulation	adultery	advantageous	advent
adventurous	adversarial	adverse	adversity
advertent	advisable	adviser	advisory
advocacy	aegis	aerial	aerobic
aerobics	aerodynamic	aerosol	aerospace
aesthetic	afar	affable	affected
affection	affectionate	affective	affidavit
affiliate	affinity	affirm	affirmation
affirmative	affix	afflict	affluent
affront	aficionado	afield	afloat
afoot	aforementioned	aft	afterlife
aftershock	afterthought	afterwards	aged
agenda	age-old	aggravate	aggregate
aggrieve	aghast	agile	agility
aging	agitate	agitation	agonize
agony	agrarian	agreeable	agribusiness
aide	ail	ailing	ailment
aimlessly	airborne	airfare	airfield
airliner	airlock	airman	airspace
airstrip	airtight	airwave	aisle
ajar	akin	alarming	albeit
alchemy	alcoholic	alcoholism	alcove
alderman	ale	alert	alfalfa
algae	algebra	Algerian	algorithm
alibi	alienation	alight	align
alignment	allay	allegation	allege
allegedly	allegiance	allegorical	allegory
allergen	allergic	allergy	alleviate
alleyway	allied	all-important	allocation
allot	allotment	all-out	allowance
alloy	all-purpose	allude	allure
alluring	allusion	ally	almighty
almond	aloft	aloof	alpine
al-Qaeda	altar	alteration	altercate
alternate	alternative	altitude	altruism
altruistic	alum	alumnus	amalgam
amass	amateur	amazed	amber
ambience	ambient	ambiguity	ambiguous
ambivalence	ambivalent	amble	ameliorate
amenable	amend	amendment	amenity
amiable	amidst	amino	amiss
ammonia	amnesia	amnesty	amok
amongst	amorous	amorphous	amphetamine
amphibian	amphibious	amphitheater	ample
amplifier	amplify	amplitude	amputate
amputee	amulet	amuse	amusement
amusing	anachronism	anachronistic	anaerobic
anal	analog	analogous	analogy
analytic	anarchist	anarchy	anathema
anatomic	anatomy	ancestor	ancestral
ancestry	anchovy	anecdotal	anecdote
anemia	anemic	anesthesia	anew
angelic	angler	angling	Anglo
Anglo-Saxon	angst	anguish	angular
animated	animosity	annal	annex
annihilate	announcer	annoyance	annuity
anoint	anomalous	anomaly	anonymity
anorexia	ANOVA	antagonism	antagonist
antagonistic	antagonize	Antarctic	antebellum
antecedent	antelope	antenna	anterior
anthem	anthology	anthrax	anthropological
anthropologist	anthropology	anti	antibiotic
anti-communist	antics	antidote	antigen
antioxidant	antipathy	antiquated	antique
antiquity	anti-Semitic	antiseptic	antisocial
antithesis	antithetical	antler	anvil
anyhow	apartheid	apathetic	apathy
aperture	apex	aphid	apiece
apnea	apocalypse	apocalyptic	apolitical
apologetic	apologist	apostolic	appall
appalling	apparatus	apparel	apparition
appealing	appease	appellate	appendage
appendix	appetizer	appliance	applicability
applicable	applied	appoint	appointee
appraisal	appraise	appraiser	appreciative
apprehend	apprehension	apprehensive	apprentice
apprenticeship	appropriation	approve	approximation
apricot	apron	apt	aptitude
aptly	aquarium	aquatic	aquifer
arabesque	Arabian	arbiter	arbitrary
arbitration	arbitrator	arbor	arcade
arcane	archaeologist	archaeology	archaic
archbishop	archdiocese	archer	archetypal
archetype	archipelago	archival	archive
archway	Arctic	ardent	arduous
Argentine	arguable	arguably	aria
arid	arise	aristocracy	aristocrat
aristocratic	arithmetic	ark	armament
armchair	armpit	aroma	aromatic
arousal	arouse	arrogance	arsenal
arsenic	arson	arterial	artery
artful	arthritic	arthritis	artichoke
articulation	artifact	artifice	artisan
artistically	artistry	arugula	Aryan
asbestos	ascendancy	ascent	ascertain
ascetic	ascribe	ashore	ashtray
askew	asparagus	aspen	asphalt
aspire	aspirin	aspiring	assail
assailant	assassin	assemblage	assent
assertive	assertiveness	assimilate	assimilation
assort	assorted	assortment	assuage
assurance	assured	asterisk	asteroid
asthma	astound	astray	astride
astrodome	astronomer	astronomical	astronomy
astrophysicist	astute	asylum	asymmetric
atheist	athletic	atmospheric	atone
atop	at-risk	atrium	atrocity
attachment	attain	attainable	attempted
attendant	attendee	attentive	attest
attic	attire	attitudinal	attributable
attrition	attune	auburn	audacious
audacity	audible	audit	audition
auditor	auditorium	auditory	augment
aura	aural	auspice	austere
austerity	authenticity	authorial	authoritarian
authoritative	authorship	autism	autistic
autobiography	autocrat	autocratic	autograph
automate	automotive	autonomous	autonomy
autopilot	autopsy	auxiliary	avail
availability	avalanche	avant	avant-garde
avatar	avenue	averse	aversion
avert	avian	aviator	avid
avocado	avoidance	awash	awe
awful	awhile	awning	awry
axial	axiom	axle	azalea
babble	baboon	backbone	backcountry
backdrop	backer	backfire	backing
backlash	backlog	backpacker	backstage
back-to-back	backtrack	backwater	bacterial
badge	baffle	bagel	baggy
baguette	bailout	bait	bakery
balcony	bale	balk	ballad
ballast	ballerina	ballet	ballgame
ballistic	ballpark	ballplayer	ballroom
balm	balmy	balsamic	banal
banality	Band-Aid	bandanna	bandit
bandwagon	bandwidth	bang	banish
banjo	banquet	banter	baptism
baptize	barb	barbarian	barbaric
barbed	barbershop	bare	barefoot
bargain	bargaining	barge	baritone
barley	barometer	baron	baroque
barracks	barrage	bartender	barter
basal	baseman	bash	basil
bask	bass	bassist	bastard
baste	batch	bathrobe	bathtub
baton	batt	battalion	batter
battered	bawl	bayonet	bayou
bazaar	bazar	beacon	bead
beadwork	beam	beard	bearded
bearer	bearing	beater	beau
beckon	bedding	bedrock	bedspread
beefy	beehive	beeper	beet
beetle	befall	befit	beforehand
befriend	beggar	behalf	behead
behemoth	behest	behind-the-scenes	behold
beholden	beholder	beige	belated
belch	beleaguer	belie	believer
belittle	belle	belligerent	belongings
beloved	bemoan	bemused	bench
benchmark	benefactor	beneficiary	benevolence
benevolent	benign	bequeath	bequest
berate	bereave	beret	berth
beset	bestow	best-seller	betrayal
betting	bewilder	biased	biblical
bibliography	biceps	bicker	bid
bidder	bide	big-name	bigot
bigotry	big-time	bikini	bilateral
bile	bilingual	billiard	billow
binder	binge	binoculars	biodiversity
biographer	biographical	biomass	biopsy
biosolids	biosphere	bipartisan	bipartisanship
bipolar	birch	birdie	birthright
bisexual	bishop	bison	bistro
biting	bitterly	bitterness	bittersweet
biz	bizarre	blackout	blacktop
bladder	blanch	bland	blare
blasphemy	blatant	blaze	blazer
blazing	bleach	bleacher	bleak
blemish	blender	blight	blindfold
blinding	blip	bliss	blissful
blister	blistering	blithe	blitz
bloat	bloated	blob	bloc
blockade	blockage	blockbuster	bloodshed
bloom	blossom	blouse	blowout
blow-up	bluegrass	blueprint	bluff
bluish	blunder	blunt	blur
blurry	blurt	blush	boar
boarder	boarding	boardroom	boardwalk
boast	boater	bob	bode
bodice	bog	bogey	bogus
bohemian	boiling	boisterous	boldly
boldness	bolster	bombard	bombardment
bomber	bombshell	bonanza	bond
bondage	bonfire	bonnet	bony
boo	boob	bookkeeping	booklet
boom	boomer	boon	boost
booster	booty	booze	boredom
born-again	borough	Bosnian	bosom
bot	botanical	botany	botch
bottomless	bough	boulder	boulevard
bouncer	bound	boundless	bountiful
bounty	bouquet	bourbon	bourgeois
bout	boutique	bowel	bowler
boyish	brace	bracelet	bracket
brag	braid	braille	brainchild
brainwash	bran	brandish	brand-name
brandy	brash	brass	brat
bravado	bravery	brawl	brazen
Brazilian	breach	breadth	breadwinner
breakaway	breakdown	breakout	breakthrough
breakup	breathless	breathtaking	breech
breed	breeder	breeding	breezy
brew	brewer	brewery	bribe
bribery	bridal	bridle	briefcase
briefing	brigade	brilliance	brilliantly
brim	brine	brink	brisk
bristle	brittle	broach	broaden
broadly	broadside	broccoli	brochure
broil	broiler	broker	brokerage
bronze	brooch	brood	brook
broom	broth	brothel	brow
brownie	brownstone	bruise	bruising
brunch	brunette	brunt	brutal
brutality	brutalize	brute	bubbling
bubbly	bucket	buckle	bucolic
bud	Buddhism	buddhist	budding
budge	budgetary	buff	buffet
bulb	bulge	bulging	bulk
bulkhead	bulky	bulldoze	bulldozer
bulletin	bullish	bullpen	bully
bulwark	bum	bump	bumper
bumpy	bun	bungalow	bunk
bunker	bunny	buoy	buoyant
burdensome	bureaucracy	bureaucrat	bureaucratic
bureaucratism	burgeon	burglar	burglary
burial	burlap	burly	burned-out
burrito	burrow	bushel	bushy
bust	bustle	bustling	butler
butt	buttery	buttock	buttress
buyo	buyout	buzz	buzzer
buzzword	bygone	by-product	bystander
cabaret	cachet	cackle	cacophony
cactus	cadaver	caddie	cadence
cadet	cadre	café	calamity
calculus	calf	caliber	calibrate
calling	callous	cam	camaraderie
Cambodian	camcorder	cameo	cameraman
camouflage	campsite	canal	cancerous
candid	candidacy	candidly	candlestick
candor	cane	canine	canned
cannibal	cannibalism	canning	canoe
canola	canon	canonical	canopy
cantaloupe	canteen	canyon	cape
caper	capitalist	capitalize	capitol
capitulate	cappuccino	capricious	captivate
captive	captivity	captor	caramel
caravan	carbohydrate	carcass	carcinogen
carcinoma	cardboard	cardiac	cardigan
cardiology	cardiovascular	careen	carefree
caregiver	careless	carelessly	carelessness
caress	caretaker	cargo	caribou
caricature	carious	carnage	carnation
carnivore	carol	carousel	carp
carpenter	carriage	carry-on	cart
cartel	cartilage	carton	cartridge
carver	carving	cascade	case-by-case
caseload	casework	cashier	cashmere
casing	casket	casserole	caste
casting	cast-iron	cataclysm	catalogue
catalyst	catalytic	catapult	cataract
catastrophe	catastrophic	catchy	cate
catechism	categorical	categorization	categorize
cater	caterpillar	catfish	catheter
Catholicism	catwalk	Caucasian	caucus
cauldron	cauliflower	causality	causation
caustic	caution	cautionary	cautiously
cavalry	caveat	cavern	cavernous
caviar	cavity	cayenne	cedar
cede	celeb	celebrated	celebratory
celery	celestial	celibacy	celibate
cellar	cellist	cello	cellular
cement	cemetery	censor	censorship
censure	census	centennial	centerpiece
centrifugal	centrist	centuries-old	ceramic
cerebral	ceremonial	certify	cervical
cessation	chafe	chagrin	champ
champagne	chancellor	chandelier	chaotic
chap	chapel	chaplain	chappy
char	characterization	charcoal	charged
chariot	charisma	charismatic	charitable
charm	charter	chasm	chaste
chastise	chastity	chatter	chauffeur
checkbook	checker	checkered	checkpoint
checkup	cheekbone	cheerful	cheerleader
cheesy	chemo	chemotherapy	cherish
chestnut	chewy	chic	chide
chieftain	chiffon	childbirth	childless
child-rearing	chile	chilling	chime
chipped	chiropractor	chirp	chisel
chi-square	chives	chloride	chlorine
choir	choke	cholera	cholesterol
chomp	chop	chopper	choppy
choral	chore	choreography	chorus
chowder	christen	Christianity	chrome
chromium	chromosome	chronicle	chronological
chronology	chubby	chuck	chuckle
chug	chum	chunk	chunky
churn	chute	chutney	cider
cilantro	cinch	cinder	cinnamon
circuitry	circular	circulate	circulation
circumcision	circumference	circumscribe	circumstantial
circumvent	citation	cite	citizenry
citrus	citywide	civic	civics
civility	clad	claimant	clam
clamber	clamor	clamp	clandestine
clang	clapboard	clarinet	clash
clasp	class-action	classified	classy
clatter	clause	claustrophobia	clay
cleanliness	cleanse	cleanser	cleansing
cleanup	clearance	clear-cut	clearinghouse
cleat	cleavage	clemency	clench
clergy	clergyman	cleric	clerical
cliche	clientele	climatic	clinch
cling	clinical	clinician	clink
clip	clique	clockwise	clockwork
clog	close-knit	close-up	closing
closure	clot	clothe	clothesline
cloudless	clout	clove	clover
clown	cluck	clueless	clump
clumsy	cluster	clutch	clutter
coalesce	coal-fired	coalition	coarse
coastal	coax	cobalt	cobble
cobbler	cobblestone	cobweb	coca
cockpit	cocky	cocoa	cocoon
cod	codify	coed	coefficient
coerce	coercion	coercive	coffer
co-founder	cog	cognition	coherence
coherent	cohesion	cohesive	cohort
coil	coincide	coincidental	coincidentally
coinstantaneous	coke	collaborate	collaborative
collaborator	collage	collagen	collateral
collective	collegiate	collie	cologne
colon	colonel	colonialism	colonist
colonization	colonize	coloration	colt
coma	comatose	combatant	combative
combo	combust	combustion	comedian
comet	comforter	comforting	comfy
comic	comical	comma	commandeer
commanding	commandment	commando	commemorate
commemoration	commemorative	commence	commencement
commend	commensurate	commentary	commentator
commerce	commission	commissioner	commitment
commodity	commonality	commoner	commonplace
commonwealth	commotion	communal	commune
communicative	communion	communique	communism
community-based	commute	commuter	compact
comparable	comparative	compart	compartment
compass	compassion	compassionate	compatriot
compendium	compensatory	competence	competent
competitiveness	compilation	complacent	complement
complementary	complexion	compliance	compliant
complicate	compliment	complimentary	composite
compositional	compost	composure	compress
comprise	compromise	compulsion	compulsive
compulsory	computerize	con	conceal
concede	conceit	conceivable	conceive
concentric	conceptualize	conceptually	concerted
concerto	concession	concierge	conciliatory
concise	concluding	conclusive	concoct
concoction	concomitant	concourse	concur
concurrent	concuss	concussion	condemn
condemnation	condensation	condense	condescend
condiment	conditioner	condo	condole
condolence	condominium	condone	condor
conducive	conduit	cone	confect
confederation	confer	confessional	confidant
confide	confidential	confidentiality	confine
confinement	confirmation	confiscate	confluence
conform	conformity	confound	confrontation
confrontational	congeal	congenial	congenital
congest	congestion	conglomerate	congregate
congregation	congressman	congruency	congruent
conifer	conjecture	conjunct	conjunction
conjure	connoisseur	connotation	connote
conquest	conscience	conscientious	conscious
conscript	consecutive	consensual	consensus
consent	consequent	consequently	conservation
conservationist	conservative	conservatory	conserve
considerate	consign	consistency	consolidate
consonant	consortium	conspicuous	conspirator
constellation	consternation	constituency	constituent
constitute	constitutionality	constitutive	constrain
constraint	constrict	constructive	construe
consulate	consultation	consultative	consummate
containment	contaminant	contamination	contemplate
contemplative	contemporary	contempt	contemptuous
contend	contender	contented	contention
contentious	contentment	contextual	contiguous
continental	contingency	contingent	continuation
continuity	continuously	continuum	contort
contour	contraception	contraceptive	contraction
contradict	contradiction	contradictory	contraption
contrary	contrasting	contributor	contrive
contrived	controversial	controversy	controvert
conundrum	convection	convenience	convent
convention	conventional	converge	convergence
conversational	converse	conversely	convey
conveyor	convict	convince	convolute
convoy	convulsion	coo	cooker
cooling	co-op	co-opt	coordinate
cope	copier	coping	copious
coral	cord	cordial	cordless
corduroy	coriander	cork	corkscrew
cornerback	cornerstone	cornmeal	cornstarch
corny	corollary	corona	coronary
coronation	coroner	corporal	corporate
corps	corpus	corral	correctional
correlate	correlation	correspondence	corresponding
correspondingly	corridor	corroborate	corrosive
corrugate	corset	cortex	cosmic
cosmology	cosmopolitan	cosmos	costar
cost-effective	costly	cot	cottage
cottonwood	cougar	council	councilman
counsel	counselor	countdown	countenance
counteract	counterattack	counterbalance	counterculture
counterfeit	counterpart	counterpoint	counterproductive
countertop	coup	coupe	coupling
couponist	courageous	courier	courteous
courtesy	courtly	courtship	courtyard
couture	covenant	coveralls	covert
covertly	cover-up	covet	cower
coy	coyote	cozy	crack
crackdown	cracking	crackle	cradle
craftsman	craftsmanship	crafty	craggy
cram	cramp	cramped	cranberry
crank	cranky	cranny	crap
crass	crate	crater	crave
crawl	crayon	craze	creak
crease	creationism	credence	credential
creditor	credo	creed	creep
creepy	crepe	crescendo	crescent
crest	crevice	crib	criminalize
crimson	cringe	crinkle	cripple
crippling	crispy	criteria	critical
critique	critter	croak	Croat
crock	crocodile	croissant	crony
crook	crooked	croon	cropped
cross-examination	crossfire	cross-legged	crossover
cross-section	cross-sectional	crosstalk	crosswise
crossword	crotch	crouch	crow
crowded	crown	crucial	crucifix
crucify	crude	cruel	cruelty
cruise	cruiser	crumb	crumble
crump	crumple	crunch	crunchy
crusade	crush	crushing	crust
crusty	crutch	crux	crypt
cryptic	crystalline	crystallize	cub
cubic	cubicle	cuddle	cue
cuff	cuisine	cul-de-sac	cull
culminate	culmination	culprit	cult
cultivar	cultivated	cultured	cumbersome
cumin	cumulative	cunning	cupboard
curator	curb	curbside	curd
curfew	curl	curler	curling
currant	curricular	curriculum	cursive
cursory	curtail	cushion	cusp
custard	custodial	custodian	customary
custom-made	cutback	cut-off	cutthroat
cutting	cutting-edge	cyanide	cyberspace
cyclical	cyclist	cyclone	cylinder
cylindrical	cynical	cynicism	cypress
cyst	cystic	czar	Czech
dab	dabble	daffodil	dagger
dainty	dairy	dais	daisy
dam	dame	damned	dampen
damper	dandelion	dandy	dangle
dank	dapper	daring	darn
dart	dashing	dated	daunt
daunting	dawn	daybreak	daycare
day-to-day	daze	dazzle	dazzling
deacon	dead-end	deadlock	deafen
dealership	dealings	dean	dearly
dearth	deathbed	debacle	debatable
debilitate	debilitating	debtor	debunk
debut	decadency	decadent	decay
decease	deceit	deceive	decency
decent	decentralize	deception	decidedly
deciduous	decimate	decipher	decision-making
decisive	decompose	deconstruct	décor
decorative	decorum	decoy	decree
decrepit	decry	dedicated	dedication
deduce	deduct	deductible	deduction
deed	deem	deepen	deepening
deep-seated	defamation	default	defect
defection	defector	defenseless	defenseman
defer	deference	defiant	defibrillator
deficiency	deficient	deficit	definitive
definitively	deflation	deflect	deforestation
deform	deformed	deformity	defraud
deft	defunct	defuse	degenerate
degenerative	degradation	degrade	dehydrate
deity	delectable	delegation	deleterious
deli	deliberate	deliberately	deliberation
delible	delicacy	delicate	delight
delighted	delightful	delineate	delinquency
delinquent	deliverance	delude	deluge
delusion	deluxe	delve	demanding
demean	demeanor	dement	dementia
demise	democratic	democratization	democratize
demographic	demography	demolish	demolition
demon	demonic	demonize	demonstrator
demoralize	demote	denial	denigrate
denim	denizen	denominate	denomination
denominator	denote	denounce	dent
dental	denunciation	departed	dependence
dependent	depict	depiction	deplete
depleted	depletion	deplorable	deplore
deport	deportation	depose	deposit
deposition	depositor	depot	depreciate
depress	depressive	deprivation	deprive
deputy	derail	derailleur	derby
deregulate	derelict	deride	derision
derivative	derive	dermatology	derogatory
descendant	descriptive	desegregation	deserted
designate	designated	designation	desirability
desirable	desolate	desolation	despair
desperate	desperation	despicable	despise
despondent	destabilize	destine	destitute
destructive	detach	detachment	detention
deter	detergent	deteriorate	deterioration
determinant	determinism	deterrence	deterrent
detest	detonate	detonation	detour
detract	detractor	detriment	detrimental
detritus	devaluation	devalue	devastate
devastating	devastation	deviant	deviation
devious	devise	devoid	devolve
devoted	devotee	devotion	devotional
devour	devout	dew	dexterity
diabetes	diabetic	diagnosis	diagnostic
diagonal	dial	dialectic	dialysis
diameter	diaper	diarrhea	diaspora
diatribe	diced	dichotomous	dichotomy
dictate	dictator	dictatorship	dictum
didactic	die-hard	dietary	dietitian
difect	differential	differentiation	diffusion
digestion	digger	digitize	dignified
dignify	dignitary	dike	dilapidate
dilapidated	dilate	dilemma	diligent
dill	dilute	dim	diminish
diminutive	dimple	din	dine
diner	dingy	diocesan	diocese
diode	dioxide	diploma	diplomat
dire	directional	directive	disaffect
disapproval	disapprove	disarmament	disarray
disastrous	disavow	disband	disbelief
discard	discern	discernible	discerning
discharge	disciple	disciplinary	discipline
disciplined	disclaimer	disclose	disclosed
disclosure	disconcert	discontent	discontinue
discontinuity	discord	discouraging	discredit
discreet	discrepancy	discrete	discretion
discretionary	discriminant	discriminatory	discursive
disdain	disembark	disembodied	disenchant
disengage	disengagement	disfigure	disgrace
disgruntled	dishearten	disillusion	disillusionment
disingenuous	disintegrate	disintegration	dislocate
dislodge	dismal	dismantle	dismay
dismissal	dismissive	dismount	disobedience
disparage	disparate	disparity	dispatch
dispel	dispense	dispenser	dispersal
disperse	dispersion	displace	displacement
disposable	dispose	disposition	disproportional
disproportionate	disprove	dispute	disqualify
disregard	disrespect	disrupt	disruptive
dissatisfied	dissect	disseminate	dissent
dissenter	dissertation	disservice	dissident
dissimilar	dissipate	dissolution	dissolve
dissonant	dissuade	distal	distaste
distasteful	distil	distinctive	distinctly
distort	distortion	distraction	distraught
distribute	distributor	disturbance	ditch
diva	diverge	divergency	divergent
diversification	diversify	diversion	divert
divest	dividend	divination	divine
divinity	divisional	divisive	divulge
dizzy	doable	docile	docket
docking	doctoral	doctorate	doctrinal
doctrine	dodge	doe	dogged
dogma	dogmatic	dogwood	dollop
domesticate	dominance	dominion	domino
don	donor	doomed	doormat
doorstep	door-to-door	dopamine	dope
dormant	dormitory	dosage	dose
dot-com	dotted	double-digit	double-edged
doubtful	dough	doughboy	doughnut
dour	douse	dove	downfall
downgrade	downhill	downplay	downpour
downright	downside	downsize	downstream
downtime	down-to-earth	downturn	downwind
doze	drab	draconian	drain
drainage	dramatize	drape	drapery
drastic	drawback	drawl	dread
dreadful	dreamer	dreamy	dreary
dredge	drench	dresser	dressing
dribble	drift	driftwood	drill
drinker	drip	drive-by	drive-in
drizzle	drone	drool	drooping
droplet	drop-off	dropout	drought
drove	drown	drowning	drumbeat
drunkenness	dryly	dualism	duality
dub	dubious	duct	dud
dues	duet	duffel	dugout
dull	duly	dumb	dumbbell
dumbfound	dummy	dump	dumpster
dune	dung	dungeon	dunk
duo	dupe	duplex	duplication
durable	dusk	duster	dwarf
dwell	dweller	dwelling	dwindle
dwindling	dye	dynamism	dynamite
dysfunction	dysfunctional	earmark	earnest
earring	earshot	earthen	earthly
ease	easel	eater	eatery
eavesdrop	ebb	ebony	eccentric
eccentricity	ecclesiastical	echelon	echo
eclectic	eclipse	ecological	ecologist
ecology	ecosystem	ecstasy	ecstatic
ecumenical	eddy	edgy	edible
edict	edifice	editorial	eel
eerie	efficacy	effigy	effluent
effortless	egalitarian	eggplant	ego
egregious	ejaculate	elasticity	elate
elation	eldest	electoral	electorate
electrician	electrify	electrode	electromagnetic
elevated	elevation	elicit	eligibility
eligible	elitist	elk	ellipse
elliptical	elongate	eloquence	eloquent
elucidate	elude	elusive	emanate
emancipation	embankment	embargo	embark
embarrassed	embassy	embattled	embellish
emblazon	emblem	emblematic	embodiment
embody	embolden	embrace	embroider
embroidery	embroil	embryo	embryonic
emerald	emergent	emeritus	emigration
emigre	eminent	emissary	emit
empathetic	empathize	empathy	emperor
emphatic	emphatically	emphysema	empire
empirical	empower	empowerment	emulate
enact	enactment	enamel	enamor
encampment	encapsulate	encase	enchant
enchanted	encircle	enclave	enclose
enclosure	encore	encroach	encyclopedia
endanger	endearing	endeavor	endemic
endorse	endorsement	endow	endowment
endurance	enduring	energize	energy-efficient
enforce	enforceable	engaging	engrave
engulf	enigma	enigmatic	enjoyable
enjoyment	enlarge	enlighten	enlightened
enlist	enlistment	enliven	enmity
enormity	enquirer	enrage	enrich
enrichment	enroll	ensconce	ensemble
enshrine	enslave	ensue	ensuing
entail	entangle	entanglement	enterprising
entertainer	enthuse	enthusiast	entice
entitle	entitlement	entomologist	entourage
entrant	entrée	entrench	entrepreneur
entrepreneurial	entrust	entryway	entwine
enumerate	enunciate	envelop	enviable
envious	environ	environmentalist	envisage
envision	envoy	enzyme	eon
ephemeral	epic	epicenter	epidemic
epidemiologic	epidemiologist	epidemiology	epilepsy
epiphany	episcopal	episodic	epistemology
epitome	epitomize	epoch	equalize
equate	equator	equatorial	equestrian
equilibrium	equitable	equivalence	equivocal
equivocate	eradicate	eradication	erect
erode	erosion	erotic	err
errand	errant	erratic	erroneous
erstwhile	erupt	escalate	escalation
eschew	escort	esophagus	esoteric
espionage	espouse	espresso	essayist
esteem	estrange	estranged	estrogen
estuary	etc	etch	etching
eternity	ethanol	ether	ethereal
ethic	ethical	ethically	ethicist
ethnic	ethnical	ethnicity	ethnographer
ethnographic	ethnography	ethos	etiology
etiquette	Eucharist	eulogy	euphemism
euphoria	euphoric	eureka	euro
euthanasia	evade	evaluator	evangelical
evangelist	evaporate	evasion	evasive
ever-changing	ever-increasing	everlasting	ever-present
evict	evident	evince	evocation
evocative	evoke	evolve	evolving
exacerbate	exaggerate	exaggerated	exaggeration
exalt	exalted	exasperate	excavate
excavation	exceeding	excel	excellence
exceptional	exceptionally	excerpt	excessive
excessively	excise	excision	exclaim
exclamation	exclusionary	excruciating	excursion
executioner	executive	exemplary	exemplify
exemption	exert	exhale	exhaust
exhaustion	exhaustive	exhibitor	exhilarate
exhort	exhortation	exile	existential
exodus	exonerate	exorbitant	exotic
expanse	expansive	expatriate	expectancy
expectant	expedite	expedition	expel
expend	expendable	expenditure	experiential
expertise	expire	explanatory	expletive
explicable	explicate	explicit	exploit
exploitation	exploratory	explorer	exponent
exponential	exponentially	exporter	expositions
expound	expressive	expressly	expulsion
exquisite	extant	extensively	exterminate
extermination	extinct	extinction	extinguisher
extol	extort	extract	extraction
extracurricular	extradition	extramarital	extrapolate
extravagance	extravagant	extremity	extricate
extrinsic	exuberance	exuberant	exude
eyeball	eye-catching	eyelash	eyelid
eyepiece	eyesight	eyewitness	fab
fable	fabled	fabric	fabricate
fabrication	fabulous	façade	faceless
face-lift	facet	facilitate	facilitator
facsimile	factual	faculty	fad
faint	faintly	fairness	fairy
faith-based	fallacy	fallout	fallow
falsehood	falsify	falter	faltering
famed	familial	familiarity	familiarize
famine	fanatic	fanatical	fanaticism
fanciful	fancy	fanfare	fang
fantasize	farce	fare	far-fetched
far-flung	farmland	far-off	far-reaching
fascinate	fascinating	fascination	fascist
fashionable	fastener	fatality	fateful
fat-free	fathom	fatigue	faucet
faulty	fauna	favorable	favorably
favored	favoritism	fawn	fearful
fearsome	feasible	feasiblity	feast
feat	feathery	fecal	feces
fed	federalism	federalist	feeble
feeder	feign	feisty	fell
fella	felon	felony	feminine
femininity	feminist	femur	fend
fender	fennel	feral	ferment
fern	ferocious	ferocity	ferry
fertility	fertilize	fervent	fervor
festive	festivity	festoon	fetal
fetish	fetus	feud	feudal
feverish	fiance	fiasco	fiat
fiberglass	fibrosis	fibrous	fickle
fictional	fictitious	fiddle	fidelity
fidget	fielder	fieldwork	fiery
fiesta	fig	figurative	figurine
filament	filet	filibuster	Filipino
fillet	filth	filtration	finale
finalist	finality	finalize	financier
finder	finely	finesse	fine-tune
finite	Finnish	fir	firearm
firefight	fireplace	firestorm	first-degree
firsthand	first-rate	fiscal	fishery
fishy	fissure	fistful	fitting
fixate	fixture	fizzle	flagrant
flagship	flail	flair	flak
flake	flaky	flamboyant	flammable
flank	flannel	flap	flare
flashback	flask	flatly	flatten
flatter	flattery	flaunt	flaw
flawed	flawless	flea	fleck
fledge	fledgling	fleece	fleet
fleeting	Flemish	flex	flexion
flick	flicker	flier	flimsy
flinch	fling	flint	flip
flipper	flit	flock	flooding
floodplain	flooring	flop	floppy
flora	floral	Florentine	florist
flounder	floured	flourish	flowerbed
fluctuate	fluctuation	fluent	fluff
fluffy	fluidity	fluke	flunk
fluorescent	flurry	flutter	flux
focal	fodder	foe	foil
folded	folding	foliage	folic
folklore	follow-up	folly	fondle
fondness	foodstuff	foolproof	footage
foothill	foothold	footing	footnote
footstep	footwear	forage	foray
forbidding	forceful	forebear	foreclose
foreclosure	forefather	forefront	forego
foregoing	foreground	foreman	foremost
forensic	forerunner	foreshadow	forestall
forester	forestry	forfeit	forge
forgery	forgiving	forgo	forlorn
formality	formally	formative	formidable
formulate	formulation	for-profit	forsake
forthcoming	forthright	fortification	fortitude
fortunate	fossil	foster	foul
founder	foundry	fountain	fowl
foyer	fraction	fracture	fragile
fragility	fragmentary	fragmentation	fragrance
fragrant	frail	frailty	framer
framing	franchise	franchisee	frank
frantic	fraternal	fraternity	fraudulent
fraught	fray	freak	freckle
freelance	freelancer	free-standing	freight
freighter	frenetic	frenzy	fresco
freshen	freshly	fret	Freud
friction	fright	frigid	frill
fringe	frivolous	frock	frontal
frontier	front-runner	frost	frosty
frothy	frown	frugal	fruitful
fruition	fruitless	fruity	frustrating
fucker	fudge	fugitive	fulfill
fulfillment	fullback	full-blown	full-fledged
full-length	fullness	full-service	full-size
fumble	fume	fundamentalism	fundamentalist
fund-raiser	fund-raising	fungal	fungus
funk	funky	funnel	furbish
furious	furnace	furnishings	furor
furrow	furry	furthermore	furtive
fuselage	fusion	fuss	futile
futility	futurist	futuristic	fuzz
fuzzy	gadget	gag	gait
gal	gala	galactic	gale
gall	gallant	galley	galvanize
gambit	gamma	gamut	gape
gaping	garb	gardener	gargantuan
garish	garland	garment	garner
garnish	garrison	gaseous	gash
gasp	gastrointestinal	gated	gatekeeper
gateway	gaudy	gauge	gaunt
gauntlet	gauze	gawk	gazebo
gear	geek	gel	gelatin
gem	gendered	genealogy	generalizability
generalization	generalize	generic	generosity
genesis	genetically	geneticist	genetics
geniality	genie	genital	genocide
genome	genre	genteel	genuinely
genus	geographic	geographical	geologic
geological	geologist	geology	geometric
geometry	geopolitical	Georgian	geothermal
geranium	geriatric	germinate	getaway
geyser	ghastly	ghetto	ghostly
giddy	giftedness	gig	gigantic
giggle	gild	gilded	gilt
gimmick	gin	gingerbread	gingerly
girlish	girth	gist	giveaway
gizmo	glacial	glacier	glamor
glamorous	gland	glare	glaring
glassware	glassy	glaze	glazed
gleam	glean	glee	glide
glider	glim	glimmer	glimpse
glint	glistening	glitch	glitz
gloat	globular	gloom	gloomy
glorify	glorious	gloss	glossary
glossy	gloved	glow	glower
glowing	glucose	glut	gnarled
gnaw	goad	goalie	goatee
gobble	gobbler	goblet	goblin
goddamn	goddess	going	gondola
gong	goo	goodness	goodwill
goody	goof	goofy	goon
gorge	gorgeous	gory	gospel
gossip	gothic	gouge	gourd
gourmet	governance	gown	gracious
graciously	grad	grader	gradient
graduated	graffiti	graft	grain
grainy	grand	grandeur	grandiose
grandkid	granite	granny	grant
granulate	grapefruit	grapevine	graphite
grapple	grasp	grasshopper	grass-roots
grate	gratification	gratify	gratitude
gratuitous	grave	gravel	gravestone
gravitate	gravitational	gravy	graze
grazing	grease	greasy	greenery
greenish	gregarious	grid	gridlock
grief	grievance	grieve	grill
grille	grim	grimace	grime
grimy	grin	grind	grinding
gripe	gripping	grisly	grit
gritty	grizzly	groan	grocer
groggy	groin	groom	groove
grope	gross	grotesque	grotto
grounding	groundwater	groundwork	groupie
grouse	grove	grower	growl
grub	grudge	grudging	grue
gruel	grueling	gruesome	gruff
grumble	grumpy	grunt	guaranteed
guarded	guardian	gubernatorial	guerrilla
guiding	guild	guise	guitarist
gulf	gully	gulp	gumbo
gunpoint	gunpowder	gurney	guru
gush	gusto	gut	gutsy
gutter	gymnasium	gymnast	gymnastics
gynecologist	gypsy	habitable	habitat
habitation	hacienda	haggle	hail
haircut	hairdo	hairline	hairy
half-hearted	halfway	halibut	hallmark
hallowed	hallucination	halt	halter
halting	halve	hamlet	hammock
hamper	hamstring	handcuff	handful
hand-held	handicap	handicapped	handily
handlebar	handler	handling	handmade
handout	hand-painted	handset	hands-on
hangar	hanger	hanging	hangout
hangover	haphazard	hapless	harass
harbinger	harbor	hardball	hard-boiled
hard-core	hardcover	hard-liner	hard-pressed
hardship	hardwood	hardy	hare
harem	harmonic	harmonious	harmonize
harmony	harness	harp	harrowing
harsh	hash	hassle	haste
hatch	hatchery	hatchet	hatred
haul	haunch	haunt	haunted
haunting	haven	havoc	hay
hazard	hazardous	haze	hazelnut
hazy	headband	headboard	headless
headliner	headlong	headmaster	headnote
head-on	headset	headstone	head-to-head
headwaters	headway	heady	heap
hearsay	heartfelt	heartily	heartland
hearty	heated	heating	heave
heavenly	heavy-duty	heavy-handed	heavyweight
heck	hectic	hedge	heed
heft	hefty	hegemonic	hegemony
heinous	heir	heirloom	helium
hellish	helm	helping	hem
hemisphere	hemlock	hemorrhage	hemp
henceforth	hepatitis	herbal	herbicide
herder	herein	heresy	heretic
heretofore	heritage	hermit	heroic
heroine	heroism	heron	herpes
herring	hesitation	heterogeneity	heterosexual
hew	heyday	hiatus	hiccup
hideaway	hideous	hideout	hierarchical
hierarchy	high-definition	high-end	high-pitched
high-rise	high-stakes	hijack	hijacker
hijacking	hike	hiker	hilarious
hillside	hilt	hind	hinder
hindrance	hindsight	hinge	hip
hippie	hiss	historiography	hitch
hitherto	hitter	hive	hoard
hoarse	hoax	hobble	hockey
hoe	hog	hoist	holding
holdout	holiness	holistic	holler
hollow	holocaust	hologram	holster
homage	homecoming	homely	homemade
homemaker	homeowner	homestead	homey
homily	homogeneity	homogeneous	homophobia
hone	honk	honorable	honorary
honored	hood	hooded	hoof
hoop	hoopla	hoot	hopper
horizon	hormonal	hormone	horny
horrendous	horrid	horrific	horse-drawn
horseman	horseradish	horseshoe	horticultural
hose	hospice	hospitable	hospitalization
hospitalize	hostess	hostile	hostility
hotshot	hound	household	housekeeper
howl	hub	hubris	huddle
hue	huff	hulking	hull
hum	humane	humanist	humanistic
humanitarian	humanities	humanize	humanly
humble	humbling	humiliation	humility
humorous	hump	hunch	hunker
hurdle	hurl	hurriedly	hurtle
hush	husk	husky	hustle
hustler	hybrid	hydrant	hydraulic
hydrocarbon	hydroelectric	hydrogen	hyena
hygiene	hymn	hype	hyperactive
hyperactivity	hyperbole	hypertension	hypnosis
hypnotic	hypnotize	hypocrisy	hypocrite
hypocritical	hypothermia	hypothesis	hypothesize
hypothetical	hysterectomy	hysteria	hysterical
iced	Icelandic	iconography	ideal
idealism	idealize	ideally	identical
identifiable	ideological	ideologically	ideology
idiom	idiosyncrasy	idiosyncratic	idiotic
idly	idolize	idyllic	ignite
ignition	ignorant	ilk	illegitimate
ill-fated	illicit	ill-informed	illiteracy
illiterate	illuminate	illuminated	illuminating
illumination	illusory	illustrative	illustrious
imagery	imaginary	imaginative	imbue
imitate	immaculate	immediacy	immense
immensely	immerse	imminent	immobile
immortalize	immunize	immutable	impair
impairment	impart	impartial	impasse
impassion	impassive	impeach	impeachment
impeccable	impede	impediment	impel
impending	impenetrable	imperative	imperfection
imperial	imperialism	imperil	impersonal
impersonate	impervious	impetus	impinge
implant	implantation	implausible	implicate
implicit	implore	importation	impotence
impotent	impoverish	impressionist	imprint
imprison	imprisonment	improbable	impromptu
improper	impropriety	improvisation	improvise
impulse	impulsive	impunity	impurity
in	inability	inaction	inadequacy
inadvertent	inanimate	inappropriately	inasmuch
inattention	inaudible	inaugural	inaugurate
inauguration	incandescent	incapable	incarcerate
incarceration	incarnation	incendiary	incense
incentive	incept	inception	incessant
incest	incidence	incident	incidental
incidentally	incinerate	incipient	incise
incision	incite	inclination	incline
inclusion	inclusive	incoherent	incoming
incompetence	inconceivable	inconclusive	incongruous
inconsequential	inconsistent	incontinence	incorporate
incorporation	incredulous	increment	incremental
incriminating	incubate	inculcate	incumbent
incur	incursion	indebted	indecent
indecision	indefinite	indentation	in-depth
indeterminate	indicative	indicator	indict
indie	indifference	indifferent	indigenous
indigent	indignant	indignation	indignity
indigo	indiscriminate	indispensable	indistinct
individualistic	indoctrination	indoors	induce
inducement	induct	induction	indulge
indulgence	indulgent	industrialist	ineffective
ineffectual	ineligible	inept	inequality
inequity	inert	inertia	inescapable
inevitable	inevitably	inexorable	inexperience
inexplicable	inextricable	infallible	infamous
infant	infatuation	infectious	infer
inference	inferior	inferno	infertile
infertility	infest	infestation	infidel
infidelity	infield	infighting	infiltrate
infinite	inflame	inflammation	inflammatory
inflatable	inflection	inflexible	inflict
inflow	influential	influenza	influx
informally	informant	informative	informed
informer	infract	infraction	infrared
infrastructure	infrequently	infringe	infuriate
infuse	infusion	ingenious	ingenue
ingenuity	ingest	ingrain	inhabit
inhabitant	inhale	inherent	inheritance
inherited	inhibit	inhibition	inhibitor
inhospitable	inhuman	injunction	inkling
inland	inlay	inlet	innate
inner-city	innermost	inning	innkeeper
innocence	innocently	innocuous	innovate
innovation	innovator	innuendo	innumerable
inoculate	inordinate	inpatient	inquire
inquiry	inquisitive	inroad	inscribe
inscription	inscrutable	insecticide	insecure
insensitive	insensitivity	inseparable	in-service
inset	insider	insidious	insight
insightful	insignia	insignificant	insinuate
insistence	insistent	insomnia	inspirational
instability	installation	installment	instantaneous
instigate	instill	institutional	institutionalize
instructional	instructor	instrumental	instrumentation
insular	insulate	insulating	insulin
insult	insure	insurer	insurgency
insurgent	insurmountable	insurrection	intact
intake	intangible	integral	integrate
integrative	integrity	intellectually	intelligentsia
intelligible	intended	intensify	intensively
intent	intentional	intentionally	interactive
interagency	intercede	intercept	interception
interchange	intercollegiate	intercom	intercourse
interdependence	interdiscipline	interfaith	interfere
interference	intergovernmental	interim	interject
interlock	interlocutor	interlude	intermediary
intermediate	interminable	intermission	intermit
intermittent	intern	internalize	internally
internist	internment	internship	interpersonal
interplay	interpretation	interpretive	interrelated
interrelationship	interrogate	interrogation	intersect
intersection	intersperse	interstate	interstellar
intertwine	interval	intervene	intervening
intervention	interviewee	interviewer	interweave
intestinal	intestine	intifada	intimacy
intimate	intimately	intimidate	intolerable
intolerant	intonation	intone	intoxicate
intoxication	intractable	intravenous	intrepid
intricacy	intricate	intrigue	intriguing
intrinsic	introductory	introspection	intrude
intruder	intrusion	intrusive	intuition
intuitive	inundate	invalidate	invaluable
invariable	inventive	inversion	invert
invertebrate	investigative	invigorate	invincible
inviting	invocation	invoice	invoke
involuntary	involvement	inward	inwardly
iodine	ion	irate	ire
iridescent	iris	irk	ironing-board
irresistible	irrespective	irresponsible	irreverent
irrevocable	irrigate	irrigation	irritability
irritable	irritant	irritate	irritation
islamist	isolated	isolationist	isotope
issuer	itch	iteration	itinerant
ivory	ivy	jab	jackpot
jade	jaded	jagged	jaguar
jalapeno	janitor	jar	jargon
jasmine	jaunt	jaunty	jealousy
jeez	jeopardise	jeopardy	jerky
jersey	Jesuit	jetliner	jettison
jewel	jeweler	jewelry	jig
jiggle	jigsaw	Jihad	Jihadist
jitter	jittery	jobless	jock
jockey	jog	jogger	joint
joist	jolly	jolt	jostle
jot	journalistic	jubilant	judgemental
judicial	judiciary	judicious	jug
juggernaut	juggle	jukebox	jumble
jumbo	jumpsuit	junction	juncture
juniper	junkie	junkyard	junta
jurisdiction	jurisprudence	jurist	juror
justifiable	justified	justly	jut
juxtapose	juxtaposition	kale	karaoke
karate	karma	kayak	keen
keeping	keg	kempt	kerosene
ketchup	keynote	keypad	khakis
kickback	kidnap	kiln	kimono
kin	kinda	kindle	kinetic
kink	kinship	kiosk	kitsch
knack	knapsack	knead	knitting
knob	knockout	knoll	knowhow
knowingly	knowledgeable	knuckle	Koran
kosher	Kuwaiti	labor-intensive	laborious
labourer	labyrinth	lackluster	lacquer
lacrosse	lacy	lad	lade
laden	ladle	lag	lagoon
laid-back	lair	laissez-faire	laity
lame	lament	laminate	lance
landed	lander	landfill	landlady
landmark	landowner	landslide	land-use
languid	languish	lanky	lantern
lap	lapel	lapse	lard
largemouth	larger-than-life	lark	larva
lasagna	lash	latch	latent
lateral	latex	latte	latter-day
lattice	laud	laughable	launder
laureate	laurel	lava	lavender
lavish	lavishly	law-abiding	lawful
lawless	lawmaker	lax	layman
layoff	leach	leaflet	leaguer
leakage	leaky	lean	leap
learned	lease	leash	leathery
ledge	ledger	leech	leek
leery	leeway	left-hander	leftist
leftover	lefty	legality	legalization
legalize	legging	legion	legislate
legislation	legislative	legislator	legislature
legitimacy	legitimate	legitimize	legume
leisure	lender	lending	lengthwise
lengthy	lenient	lentis	lesion
lessen	lesser	lest	lethal
lettuce	leukemia	levee	lever
leverage	levy	lewd	lexicon
liability	liable	liaison	liar
libel	liberal	liberalization	liberalize
libertarian	libido	librarian	lichen
lid	lieu	lieutenant	lifeboat
lifeguard	lifeless	life-saving	life-size
ligament	lighten	light-hearted	lighthouse
likable	likelihood	like-minded	liken
likeness	liking	lilac	limbo
lime	limelight	limestone	limousine
limp	lineage	linebacker	lineman
liner	lineup	linger	lingerie
lingo	linguist	linguistic	lining
linkage	lipstick	liqueur	liquidate
liquidity	liquor	listing	litany
lite	literacy	lithe	lithium
Lithuania	litigate	litigation	litigator
litmus	litter	little-known	liturgical
liturgy	livelihood	livestock	livid
lizard	llama	loader	loafer
loath	loathe	loathing	lobbying
lobbyist	lobe	locale	locality
locker	lockout	locomotive	locus
locust	lodge	lodging	loft
lofty	logger	logging	logistic
logistical	logistics	loin	loll
lone	loner	lonesome	long-awaited
longevity	long-held	longing	longitudinal
long-lived	long-range	long-standing	look-alike
lookout	loom	loophole	loot
looter	lope	lopsided	lore
lotion	lounge	lousy	low-cost
lower	low-fat	low-lying	low-wage
loyalist	lubricant	lucid	lucrative
ludicrous	lug	lukewarm	lull
lullaby	lumbar	lumber	lumbering
luminary	luminosity	luminous	lump
lumpy	lunar	lunatic	luncheon
lunge	lupus	lurch	lure
lurid	lurk	luscious	lush
lust	luster	luxurious	luxury
lymph	lymphoma	lynch	lyric
lyrical	lyrics	macabre	macaroni
machete	machinist	macho	mackerel
macro	maculate	madden	madman
maestro	mafia	magenta	maggot
magistrate	magnate	magnesium	magnet
magnetism	magnificent	magnitude	magnolia
mahogany	maid	mail-order	maim
mainline	mainstay	maize	majestic
majesty	major-league	makeover	makeshift
malady	malaise	malaria	malevolent
malfunction	malice	malicious	malignant
malleable	mallet	malnutrition	malpractice
malt	mammalian	mammogram	mammoth
managerial	mandate	mandatory	mane
maneuver	mangrove	manhood	manhunt
mania	maniac	manic	manicure
manifest	manifestation	manipulation	manipulative
mankind	manly	manned	mannequin
mannerism	manor	manslaughter	mantel
mantle	mantra	manure	manuscript
mapping	mar	marathon	marcher
margarine	marginal	marginalize	marigold
marijuana	marina	marinate	marital
maritime	markedly	maroon	marrow
marsh	marshal	marshmallow	martial
martini	martyr	martyrdom	marvel
marvelous	Marxism	Marxist	mascara
mascot	masculine	masculinity	mash
mason	masonry	masquerade	massacre
mast	mastectomy	mastermind	masterpiece
mastery	mat	matchup	materialism
materialistic	materialize	maternal	maternity
mathematician	matinee	mating	matron
matte	mattress	maturation	maturity
maverick	maxim	mayhem	mayonnaise
mayoral	maze	meager	meander
mean-spirited	measles	measured	meaty
mecca	mechanic	mechanical	medalist
medallion	meddle	medial	median
mediate	mediation	mediator	medicinal
medieval	mediocre	mediocrity	meditate
meditation	medium-high	medium-low	medley
meek	mega	megawatt	melancholy
melanoma	meld	mellow	melodic
melodrama	melodramatic	melon	meltdown
membrane	memento	memo	memorabilia
memorandum	memorial	memorialize	menace
menacing	menial	meningitis	menopause
menstrual	mentality	mentor	merchandise
merchantman	merciless	mercury	merge
merger	meringue	merit	mermaid
merrily	merry	mesa	mesh
mesmerize	mesquite	mess	messenger
messianic	messy	metabolic	metabolism
metallic	metamorphosis	metaphor	metaphorical
metaphysical	metaphysics	metastasis	mete
meteor	meteorite	meteorological	meteorologist
meth	methadone	methamphetamine	methane
methodical	methodically	Methodist	methodological
methodology	meticulous	metric	metro
metropolis	metropolitan	microbe	microbial
microchip	microcosm	micron	microorganism
microscopic	mid-air	midday	midget
midpoint	midst	midterm	midtown
midway	Midwestern	midwife	mighty
mignon	migraine	migrant	migrate
migration	migratory	mildew	mileage
milestone	milieu	militancy	militia
militiaman	mill	millennium	millimeter
mimetic	mimic	mince	mind-boggling
mindful	minefield	miner	mineral
mingle	miniature	minimalist	minimally
miniseries	ministerial	ministry	mink
minnow	minor	minor-league	mint
minuscule	minutia	miraculous	mirage
mire	mirrored	misbehave	misbehavior
miscarriage	miscellaneous	mischief	mischievous
misconduct	misdeed	misdemeanor	miserably
misfortune	misgiving	mishap	misinterpret
mislead	misperception	misplace	misrepresent
misrepresentation	missionary	misstep	mistakenly
mistress	misty	mite	mitigate
mitigation	mitt	mitten	mixer
moan	moat	mob	mobility
mobilization	mobilize	mobster	moccasin
mock	mockery	modality	modeling
moderate	moderation	moderator	modernism
modernity	modesty	modular	modulate
mogul	moil	moisture	moisturizer
molasses	mold	molded	mole
molecular	molecule	molest	molestation
molt	molten	momentarily	momentary
momentous	momentum	monarch	monarchy
monastery	monastic	monetary	mongrel
moniker	monition	monogamous	monograph
monolith	monolithic	monologue	monopolize
monopoly	monotonous	monoxide	monsoon
monstrous	montage	monument	monumental
moonlit	moor	moose	moot
mop	morale	morality	moratorium
morbid	morbidity	morgue	Mormon
moron	morph	morphine	morphology
morsel	mortal	mortality	mortar
mortify	mortuary	mosaic	mosque
mossy	moth	motif	motion
motionless	motivate	motivational	motivator
motley	motorcade	motorist	mottled
motto	mould	mound	mount
mountainside	mourn	mourner	mousse
moustache	mouthful	mover	moviegoer
mow	mower	mozzarella	MP
MRI	much-needed	muck	mucus
muddle	muffle	muffler	mug
mulch	mule	mull	multiculturalism
multi-ethnic	multilateral	multiplication	multiplicity
multiracial	multitude	multivariate	mumble
mummy	munch	mundane	municipal
municipality	munition	mural	murderous
murky	murmur	muscular	muse
mushy	musket	mussel	muster
musty	mutant	mutate	mutation
mutilate	mutilation	mutiny	mutt
mutter	mutually	muzzle	myriad
mysteriously	mystic	mystical	mysticism
mystify	mythic	mythical	mythological
mythology	nab	nag	naivety
namely	namesake	nanny	nanotechnology
nape	narcissism	narcissistic	narcotic
narrate	narration	narrative	narrowly
nasal	nascent	nationalist	nationalistic
nationalize	nation-state	naturalistic	naturalize
nausea	nautical	Navajo	naval
nave	navel	Nazism	neat
nebula	necessitate	neckline	necktie
nectar	needless	needlessly	needy
nefarious	negate	negation	neglect
negligence	negligent	negligible	negotiator
nemesis	neoliberal	neon	neophyte
nestle	nettle	neural	neurological
neurologist	neuron	neurosurgeon	neurotic
neutral	neutrality	neutralize	neutrino
neutron	nevertheless	newborn	newlywed
newscast	newsletter	newsprint	newsroom
newsstand	nexus	nibble	nicety
nick	nickle	nicotine	nifty
nightfall	nightgown	nightmarish	nightstand
nighttime	nimble	nip	nitrate
nitrogen	nix	no-brainer	nocturnal
nocuous	nomad	nomadic	nominal
nominate	nomination	nondescript	nonetheless
nonexistent	no-nonsense	nonstick	nook
noose	norm	normalcy	nostalgia
nostalgic	nostril	notable	notation
notch	noted	noteworthy	nothingness
noticeably	notion	notoriety	notorious
notwithstanding	nourish	novella	novelty
novice	noxious	nozzle	nuance
nuanced	nucleus	nude	nudge
nudity	nugget	nuisance	nuke
nullify	numbered	numbness	numerable
numeral	numerical	nun	nurture
nutmeg	nutrient	nutritionist	nutritious
nutshell	nutty	nuzzle	nylon
nymph	oar	oasis	oatmeal
oats	obedience	obedient	obese
obesity	obituary	objective	objectively
objectivity	obligate	obligatory	oblige
oblique	obliterate	oblivion	oblivious
obscene	obscenity	obscure	obscurity
observance	observant	observatory	obsess
obsessed	obsessive	obsolete	obstacle
obstetrician	obstruct	obstruction	obtain
occasion	occult	occupant	occupation
occupational	oceanic	octave	oddity
odor	odyssey	oeuvre	offbeat
off-duty	offending	officiate	off-limits
off-road	offshoot	offshore	offspring
oftentimes	oily	ointment	okra
old-timer	omelet	ominous	omnipresent
oncology	oncoming	one-bedroom	one-of-a-kind
onerous	one-sided	one-stop	one-time
one-way	onlooker	onset	on-site
onslaught	onstage	ontology	onward
ooze	opaque	op-ed	open-ended
opener	open-minded	openness	operationalize
operative	opiate	opine	opium
opportunistic	oppositional	oppress	oppression
oppressive	oppressor	opt	optic
optimal	optimum	opulent	opus
orally	orator	oratory	orb
orbiter	orchard	orchestrate	orchid
ordain	ordeal	orderly	ordinance
ordination	ore	oregano	organic
organically	organism	orgasm	orgy
orient	oriental	originality	originate
ornament	ornamental	ornate	orphan
orphanage	orthodox	orthodoxy	orthopedic
oscillate	ostensible	osteoporosis	ostracize
otherness	otter	oust	ouster
outage	outcast	outcry	outdated
outdo	outfielder	outfit	outfitter
outgoing	outgrow	outgrowth	outhouse
outing	outlandish	outlast	outlaw
outlay	outlet	outline	outlive
outlook	outlying	outmoded	outnumber
outpace	outpatient	outperform	outpost
outrage	outrageous	outreach	outright
outscore	outset	outsider	outskirt
outsource	outspoken	outstretched	outstrip
outturn	outward	outwardly	outweigh
oval	ovarian	ovary	ovation
overarching	overboard	overcast	overcoat
overdo	overdose	overdue	overgrown
overhang	overhaul	overhead	overhear
overjoyed	overlap	overlay	overload
overlook	overly	overpower	overrated
overriding	overrule	overrun	overseer
overshadow	oversight	overstate	overt
overtake	over-the-counter	overthrow	overtone
overture	overturn	overuse	overwhelm
overwhelmingly	oxidation	oxide	oyster
ozone	pacemaker	pacifist	pacify
packaging	packed	packet	pact
pad	paddle	paddy	pagan
pageant	pager	pail	painstaking
pajamas	pal	palatable	palate
paleontologist	palette	pallet	palpable
palsy	paltry	pamper	pamphlet
panacea	pancreas	pandemic	pander
pane	paneling	panelist	pang
panic	panick	panicky	panorama
panoramic	pant	pantheon	panther
pantry	panty	paparazzo	papaya
paperback	paperwork	paprika	par
parable	parade	paradigm	paradox
paradoxical	paragon	parallel	paralyse
paralysis	paralyze	paramedic	paramilitary
paramount	paranoia	paranoid	paraphrase
parasite	parasitic	paratrooper	parcel
parch	parched	parchment	pardon
pare	parental	parenthood	parenting
pariah	parish	parishioner	parity
parka	parlance	parlay	parliament
parliamentary	parlor	parochial	parochialism
parody	parole	parrot	parsley
partake	partial	participatory	particularity
particulars	particulate	parting	partisan
partisanship	partition	passageway	passionately
passivity	Passover	pasta	pastel
pastime	pastor	pastoral	pastry
pasture	pat	patch	patchwork
patent	paternal	paternity	pathogen
pathological	pathologist	pathology	pathos
patina	patio	patriarch	patriarchal
patriarchy	patriotic	patriotism	patrol
patrolman	patron	patronage	patronize
patty	paucity	pave	pavement
pavilion	paving	pawn	payable
paycheck	payday	payload	payoff
payout	payroll	peacekeeper	peacekeeping
peacemaker	peak	pearly	peasant
pebble	pecan	peccant	peculiar
peculiarity	pedagogical	pedagogy	pedal
pedant	peddler	pedestal	pedestrian
pediatric	pediatrician	pedigree	pedophile
peek	peel	peeled	peep
peg	pellet	pelt	pelvic
penal	penalize	penance	penchant
pend	pendant	pending	penetrable
penetrate	penetrating	penicillin	peninsula
penis	penitentiary	pennant	pensive
pentagon	penthouse	pent-up	pep
peppercorn	peppermint	peptide	perceive
percept	perceptible	perception	perceptive
perceptual	perch	percolate	percuss
perennial	perestroika	perfectionist	perforate
perfunctory	peril	perilous	perimeter
periodic	periodical	periodically	peripheral
periphery	perish	perjury	perk
perky	permeate	permissible	permissive
pernicious	peroxide	perpendicular	perpetrate
perpetrator	perpetual	perpetuate	perplex
persecutation	persecute	perseverance	persevere
persistence	persistent	persona	personable
personalize	personification	personify	personnel
perspire	persuasion	persuasive	pertain
pertinent	peruse	perv	pervade
pervasive	perverse	perversion	pesky
pessimism	pessimistic	pest	pester
pesticide	petal	petite	petition
petitioner	petrify	petroleum	petty
pew	pewter	phalanx	phantom
pharmaceutical	pharmacist	pheasant	phenomenal
philanthropic	philanthropy	philharmonic	philosophical
philosophically	phobia	phony	phosphate
phosphorus	photon	photosynthesis	photovoltic
phrasing	physiology	physique	pianist
piazza	picket	picky	pictorial
picturesque	pier	pierce	piety
pigment	pike	pile	piler
pilgrim	pilgrimage	pillar	pimp
pimple	pinch	pine	pinnacle
pinpoint	pioneering	pious	pipeline
piping	pique	piracy	pirate
piss	pissed	pistachio	pit
pitch	pitfall	pitiful	pivotal
placard	placate	placebo	placement
placid	plague	plaid	plainly
plaintiff	plaintive	planetarium	planetary
plantain	plantation	plasma	plaster
plateau	platelet	platinum	platonic
platoon	platter	plausible	playfully
playwright	plaza	plea	plead
pleated	pledge	plethora	plight
plod	plop	plot	plotter
plow	pluck	plug	plum
plumb	plumber	plume	plummet
plump	plunder	plunge	plunk
plural	pluralism	pluralistic	plurality
plush	plutonium	ply	plywood
pneumatic	pneumonia	poach	poacher
pocketbook	pod	podium	poetic
poetics	poetry	poignant	pointed
pointer	pointless	poise	poisonous
poke	polar	polarity	polarization
polarize	polemic	policy-making	polio
polish	politicize	polity	polka
poll	pollen	polling	pollster
pollutant	polygamy	polygraph	polymer
polyp	polyster	pomegranate	pompous
poncho	ponder	poodle	pope
poplar	poppy	populace	popularize
populate	populism	populist	populous
pop-up	porcelain	pore	pornographic
pornography	porous	portable	portal
portend	porter	portfolio	portray
portrayal	Portuguese	pose	posh
posit	posse	postage	postal
posterior	posterity	posting	postmodernism
post-mortem	postoperative	postpartum	postpone
post-traumatic	postulate	posture	potassium
potency	potent	pothole	potion
potted	potter	pottery	pouch
poultry	pounce	pounding	pout
powdered	powdery	powerhouse	pox
practicality	practicum	practitioner	pragmatic
pragmatism	pragmatist	prairie	praise
preach	preacher	preamble	precarious
precaution	precede	precedence	precedent
precept	precinct	precipice	precipitate
precipitation	precipitous	preclude	precocious
pre-Columbian	preconception	precursor	predate
predation	predator	predatory	pre-dawn
predecease	predecessor	predeterminate	predicament
predicate	predictability	predictably	predilection
predispose	predisposition	predominant	preemptive
preen	preface	preferable	preferably
preferential	preheat	prehistoric	prejudice
prejudiced	preliminary	prelude	premature
premier	premiere	premise	premium
premonition	prenatal	preoccupation	preoccupied
preoperative	prep	preparatory	preparedness
preponderate	preposterous	prerequisite	prerogative
preschool	preschooler	prescient	prescription
preseason	present-day	presenter	preservation
preservationist	preservative	pre-service	preside
presidential	pressing	prestige	prestigious
presumable	presume	presumption	presuppose
pretense	pretension	pretentious	pretext
pretzel	prevail	prevailing	prevalence
prevalent	preventative	preventive	prey
pricey	prick	prickly	pricky
priestess	priesthood	priestly	prima
primacy	primal	primate	primer
primeval	primitive	primordial	principally
principled	printout	prior	prioritize
prism	pristine	private-sector	privatization
privatize	privileged	privy	prized
proactive	probability	probation	probe
problem-solving	procedural	proceed	proceeding
proceeds	procession	proclamation	proclivity
procure	procurement	prod	prodigious
prodigy	profane	profess	professionalism
proffer	proficiency	proficient	profile
profitability	profitable	profound	profusely
profusion	progeny	prognosis	programmatic
progressive	progressively	prohibit	prohibited
projectile	proliferate	proliferation	prolific
prolonged	prom	promenade	prominence
prominent	promiscuity	promiscuous	promoter
promotional	promulgate	prone	pronoun
pronounced	pronouncement	prop	propaganda
propagate	propagation	propane	propel
propeller	propensity	prophecy	prophesy
prophet	prophetic	proponent	proportional
proportionate	proposition	proprietary	proprietor
propriety	propulsion	prosciutto	prose
prosecute	prosecution	prospect	prospective
prospector	prosper	prosperity	prosperous
prostate	prosthesis	prosthetic	protagonist
protectionism	protectionist	protégé	Protestant
Protestantism	proton	protract	protrude
proven	provenance	proverb	proverbial
provincial	provision	provisional	provocative
provoke	prowess	prowl	proximal
proximity	prudence	prudent	pry
pseudonym	psyche	psychedelic	psychiatric
psychiatrist	psychiatry	psychic	psycho
psychoanalysis	psychoanalytic	psychometric	psychopath
psychopathology	psychosis	psychosocial	psychotherapist
psychotic	puberty	pubic	publicist
publicity	publicize	puck	pucker
pudding	puddle	pudgy	pueblo
puff	puffing	puffy	puke
Pulitzer	pulley	pulmo	pulmonary
pulp	pulpit	pulsar	pulse
pun	punctual	punctuate	punctuation
puncture	pundit	pungent	punitive
punt	puny	pupil	puppet
puree	purely	purge	purification
purist	purity	purport	purportedly
purposefully	purposely	purr	purse
pursuant	purveyor	pushy	putative
putt	putter	puzzlement	quad
quadrant	quadruple	quagmire	quail
quaint	quake	Quaker	qualification
qualifier	qualitative	qualm	quandary
quantify	quantitative	quantum	quarantine
quark	quarry	quarterfinal	quartet
quartz	quasar	quash	queasy
queer	quell	quench	query
questionable	questioning	questionnaire	quid
quill	quintessential	quip	quirk
quirky	quivering	quiz	quota
quotation	quotient	rabbi	rabid
rabies	racetrack	rack	racket
racketeering	racy	radial	radiance
radical	radicalism	radically	radish
radius	radon	rafter	rafting
rag	rage	ragged	raging
raid	raider	railing	raindrop
raiser	raisin	rake	rally
ram	Ramadan	ramble	ramification
ramp	rampage	ramshackle	ranch
rancher	rancid	randomize	ransack
ransom	rapport	rapprochement	rapt
rapture	rapturous	rarity	rash
raspberry	rater	ratification	ratify
ration	rationale	rationality	rationalize
rattle	rattlesnake	raucous	ravage
rave	raven	ravine	ravioli
raze	razor	reactionary	reactor
readership	readiness	ready-made	realignment
realistically	realtor	ream	reap
rearview	reasoned	reasoning	reassert
reassess	reassessment	reassurance	reassure
rebate	rebellion	rebellious	rebound
rebuff	rebuke	rebut	rebuttal
recalcitrant	recast	recede	receipt
receptacle	reception	receptionist	receptive
receptor	recess	recipe	recipient
reciprocal	reciprocity	recital	recite
reck	reckless	reckoning	reclaim
recline	recliner	reclusive	recognition
recoil	recollect	recollection	reconciliation
reconnaissance	reconstitute	reconstruct	reconstructive
recount	recoup	recourse	recreation
recreational	recrimination	recruiter	recruitment
rectify	recuperate	recur	recurrence
recurrent	recurring	redden	reddish
redeem	redemption	redhead	red-hot
redirect	redistribute	redistribution	redress
redshift	redundancy	redwood	reed
reef	reek	reel	re-enact
ref	referee	referendum	referent
referral	refinance	refine	refined
refinement	refinery	reflective	reflector
reflex	reflexive	reformer	reformist
refractor	refrain	refrigerate	refrigeration
refund	refusal	refute	regal
regalia	regime	regimen	registrar
registry	regress	regression	regressive
regretable	regrettable	regulated	regulator
regulatory	rehab	rehabilitate	rehabilitation
rehearsal	rehearse	reimburse	reimbursement
rein	reincarnation	reindeer	reinforce
reinforcement	reinstate	reinvent	reiterate
rejoice	rejuvenate	rekindle	relapse
relativism	relay	relegate	relent
relentless	relevance	reliance	relic
relief	relieve	relieved	reliever
religiosity	religiously	relinquish	relish
relive	relocate	reluctance	reluctant
remainder	remains	remand	remark
rematch	remedial	remediate	remediation
remedy	remembrance	reminder	reminisce
reminiscence	reminiscent	remission	remittance
remnant	remodel	remorse	remotely
removal	renal	rendezvous	rendition
renegade	renege	renew	renewable
renewal	renounce	renovate	renovation
renown	renowned	rental	renter
rep	reparation	repatriation	repay
repayment	repeal	repel	repellent
repent	repentant	repercussion	repertoire
repertory	repetitive	replant	replenish
replete	replica	replicate	replication
reposition	reprehensible	representational	repress
repression	reprieve	reprimand	reprisal
reproach	reproductive	reptile	repudiate
repugnant	repulse	repulsive	reputable
requisite	rerun	rescind	resell
resemblance	resemble	resent	resentment
reserved	reservist	reservoir	resettle
reside	residency	residual	residue
resignation	resigned	resilience	resilient
resin	resistant	resolute	resolutely
resonance	resonant	resonate	resort
resound	resourceful	respectful	respecting
respective	respiration	respirator	respiratory
respite	responder	responsive	restitution
restlessness	restorative	restrained	restraint
restrictive	restructure	resultant	resumption
resurface	resurgence	resurrect	resurrection
retail	retain	retainer	retaliate
retaliation	retard	retardate	retardation
retarded	retention	reticence	reticent
retina	retiree	retiring	retool
retort	retract	retribution	retrieval
retro	retrofit	retrospect	retrospective
rev	revamp	reveal	revel
revelation	reveler	revenue	reverberate
revere	reverence	reverend	reverie
reversal	reversible	reviewer	revise
revision	revisionist	revitalize	revival
revoke	revolt	revolutionary	revolutionize
revolve	revolver	revulsion	rewarding
rhetoric	rhetorical	rheumatoid	rhino
rhododendron	rhubarb	rhyme	rhythmic
rhythmically	ribbon	rickety	ricochet
ricotta	rid	riddle	ridicule
rife	riff	rift	rig
rigging	righteous	righteousness	rightful
rigid	rigidity	rigor	rigorous
rile	rim	rind	ringer
ringing	rink	rinse	riot
rip	riparian	ripe	ripen
ripple	risotto	rite	ritual
rivalry	rivet	roach	roadblock
roadside	roadway	roam	roar
roaring	roast	roasting	robbery
robin	rockfish	rocking	rodent
rodeo	roil	roller-coaster	romanticism
roofing	rooftop	roomy	roost
rooster	rosary	rosemary	roster
rosy	rot	rotary	rote
rotor	rouge	roulette	round-trip
roundup	rout	routinely	rove
rover	roving	rowdy	rowing
rubber	rubble	rubric	ruby
rudder	ruddy	rudiment	rudimentary
rue	ruffle	rug	rugby
rugged	ruling	rum	rumble
rummage	rump	rumple	runaway
run-down	rung	run-in	runner-up
runny	runoff	run-up	runway
rupture	rural	ruse	rustic
rustle	rut	ruth	ruthless
rye	sabbatical	saber	Sabine
sabotage	sac	sack	sacrament
saddle	sadist	sadistic	safeguard
saffron	sag	sage	sagebrush
sail	saint	salamander	salespeople
salient	saline	salinity	saliva
salmon	salmonella	salon	saloon
salsa	salvage	salvation	sampler
sanction	sanctity	sanctuary	sandbag
sandglass	sandstone	sane	sanguine
sanitary	sanitation	sanity	sap
sapling	sapphire	sarcasm	sardine
sari	sassy	satanic	satchel
satiable	satin	satire	satirical
satisfactory	saturate	saturated	saucepan
saucer	Saudi	sauna	saunter
saute	savagery	savanna	saver
savior	savor	savory	savvy
sawdust	sax	scab	scaffold
scallion	scallop	scalp	scalpel
scalper	scam	scamp	scamper
scandal	scant	scape	scapegoat
scarce	scarcely	scarcity	scarecrow
scarf	scarlet	scarred	scathe
scatter	scavenge	scenery	scenic
scent	scented	schema	schematic
schism	schizophrenia	scholarly	scholastic
schoolhouse	schooling	schoolyard	schooner
sclerosis	scoff	scold	scoop
scoot	scooter	scorch	scorer
scorn	scorpion	scotch	scoundrel
scour	scourge	scout	scowl
scramble	scrap	scrapbook	scrape
scratchy	scrawl	scrawny	screech
screener	screenplay	screenwriter	screw
screwdriver	scribble	scribe	scrimmage
scriptural	scripture	scroll	scrub
scruffy	scrunch	scrupulous	scrutinize
scrutiny	scuff	sculpt	sculptor
sculpture	scum	scurry	scuttle
seagull	sealed	seam	seaman
seamless	seamstress	sear	searing
seasickness	seasoned	seasoning	seating
secession	seclude	second-degree	secrecy
secrete	secretion	secretive	sect
sectarian	sectional	sector	secular
sedative	sedentary	sediment	seduce
seductive	seedling	seedy	seeming
seep	seer	seethe	segment
segregate	segregation	seismic	seizure
self-conscious	self-consciousness	self-contained	self-destructive
self-determination	self-efficacy	self-employed	self-evident
self-government	self-help	selfless	self-pity
self-portrait	self-proclaimed	self-regulation	self-reliance
self-righteous	self-sufficiency	self-worth	semantic
semblance	semen	semiconductor	semifinal
semina	seminal	seminar	seminary
senatorial	seniority	sensation	sensational
sensibility	sensible	sensing	sensitivity
sensory	sensual	sensuous	sentiment
sentimental	sentimentality	sentry	separatist
septic	sequel	sequencing	sequential
sequester	sequin	serene	sergeant
serial	sermon	serpent	serum
servant	serviceman	servitude	setback
settee	settler	sever	severe
severity	sewage	sewer	sewing
sexism	sexist	shabby	shack
shackle	shade	shaded	shady
shaft	shaggy	Shakespearean	shaky
shale	shallot	sham	shamble
shambles	shank	shanty	shapely
shaping	shard	shareholder	shatter
shaving	shawl	sheaf	shear
sheath	shed	sheen	sheepishly
sheer	shellfish	sheltered	shelve
sherry	shifter	shifting	shimmer
shin	shingle	shining	shiny
shipment	shipping	shiver	shoddy
shopkeeper	shoplift	shortcoming	shortfall
shorthand	shortness	shortstop	shove
shovel	showcase	showy	shrapnel
shred	shrewd	shriek	shrill
shrine	shrink	shrivel	shroud
shrub	shrug	shudder	shuffle
shun	shunt	shutout	shutter
shuttered	shuttle	Siberian	sickle
sideboard	sidekick	sideline	sideshow
sidestep	sidle	siege	sieve
sift	sighted	sighting	sightsee
signatory	signify	silhouette	silicone
silken	sill	silo	simmer
simplicity	simplistic	simultaneous	simultaneously
sincere	sincerity	single-family	single-minded
singular	sinister	sinner	sinus
Sioux	sip	siphon	siren
sitcom	site	sitting	situate
situational	sizable	sizeable	sizzle
skeletal	skeptical	skepticism	sketch
skew	skewer	ski	skid
skier	skiff	skim	skimpy
skinhead	skinless	skipper	skirmish
skit	skitter	skull	skunk
skylight	skyrocket	skyscraper	slab
slack	slalom	slang	slant
slap	slash	slat	slate
slather	slaughter	slaughterhouse	slavery
slay	sleaze	sleek	sleepless
sleet	sleeveless	sleigh	slender
slew	slick	slimy	sling
slink	slippery	slit	slither
slog	sloppy	slosh	slot
slouch	sludge	slug	slugger
sluggish	slum	slumber	slump
slur	slush	slut	sly
smack	smallmouth	smallpox	smarts
smash	smashing	smatter	smear
smirk	smite	smock	smog
smokestack	smoky	smolder	smother
smudge	smug	smuggle	smuggler
snag	snap	snapper	snappy
snapshot	snare	snarl	snatch
sneaker	sneer	sneeze	snicker
sniff	snip	snippet	snob
snoop	snore	snorkel	snort
snout	snowboard	snowflake	snowmobile
snub	snuff	snug	snuggle
soak	so-and-so	soar	sober
sobriety	socialite	socialize	societal
sociological	sociologist	sociology	sock
socket	sod	sodium	softball
soften	soft-spoken	soggy	soiled
sojourn	solace	sole	solely
solemn	solicit	solidarity	solidify
solitary	solitude	soloist	solstice
soluble	solvent	somatic	somber
someday	somewhat	songbird	songwriter
sonnet	soot	soothe	soothing
sophistication	sophomore	soprano	sorbet
sorcerer	sorcery	sordid	sore
sorority	sorrow	souffl	sought-after
soulful	soundbite	soundly	soundtrack
sour	souvenir	sovereign	sovereignty
sow	soya	soybean	spacious
spaghetti	spam	spank	spar
spare	sparing	spark	sparrow
sparse	spasm	spate	spatial
spatula	spawn	spear	spearhead
spec	specialty	specifically	specification
specificity	specified	specimen	speck
speckle	spectacle	spectacularly	spectate
spectator	spectral	spectrum	speculate
speculation	speculative	speechless	spender
spew	spherical	spice	spike
spiky	spill	spin	spinach
spinal	spindly	spine	spinner
spiral	spire	spirited	spirituality
spit	spite	splash	splatter
splay	spleen	splendor	splint
splinter	splurge	spoil	spoils
spoke	spokesperson	spongy	spontaneous
spook	spooky	spool	spoonful
sporadic	spore	sporting	spotless
spotlight	spotted	spotty	spousal
spouse	spout	sprain	sprawl
sprawling	spray	spreadsheet	spree
sprig	springboard	sprinkle	sprinkler
sprinkling	sprinter	sprout	spruce
spur	spurious	spurn	spurt
sputter	squabble	squadron	squander
squarely	squash	squat	squatter
squawk	squeak	squeal	squeeze
squelch	squid	squint	squirm
squirrel	squirt	stabilization	stabilize
staccato	stadium	staffer	stag
stagger	staggering	staging	stagnant
stagnate	stain	stained-glass	stainless
stainless-steel	stairway	stairwell	stake
stakeholder	stale	stalemate	stalk
stalker	stalking	stall	stalwart
stamina	stammer	stance	standby
stand-in	standoff	standout	standpoint
standstill	stanza	staple	starboard
starch	stardom	stark	starry
starship	startle	startling	stash
stasis	statehood	state-of-the-art	stateroom
statesman	statewide	stationary	stationery
statistical	statistician	stature	statute
statutory	staunch	stave	stay-at-home
stead	steadfast	stealth	steamy
steely	steep	steeple	steer
stellar	stench	steppe	stereo
stereotype	sterile	sterilization	sterilize
sterling	stern	steroid	stethoscope
stew	steward	stewardship	stiff
stiffen	stiffness	stifle	stigma
stiletto	stillness	stilt	stimulant
stimulation	stimulus	stinging	stingy
stink	stint	stipend	stipulate
stipulation	stir-fry	stirring	stirrup
stitch	stockbroker	stockholder	stocking
stockpile	stocky	stoic	stomp
stony	stool	stoop	stoplight
stopper	store-bought	storefront	storied
storytelling	stout	stove	stow
straddle	straightforward	strain	strainer
strait	strand	stranded	strangle
strap	strapping	strategically	strategist
stratify	stratosphere	stratum	streak
streamer	streamline	streetcar	strenuous
stressor	stretch	stretcher	stricture
stride	strident	strife	strikeout
striking	strikingly	string	stringent
stripe	striped	stripped	stripper
strive	stroke	stroll	stroller
stronghold	strum	strut	stub
stubborn	stubbornly	stubby	stucco
stud	stuffing	stuffy	stumbling
stump	stun	stunned	stunning
stunt	stupidity	sturdy	sturgeon
stutter	stylish	stylist	stylistic
stylize	stymie	subcommittee	subconscious
subcontractor	subculture	subdivide	subdue
subgroup	subjective	sublime	submerge
submission	submissive	subordinate	subordination
suborn	subpena	subpoena	subprime
subsequent	subside	subsidiary	subsidize
subsidy	subsist	subsistence	substandard
substantial	substantiate	substantive	substitute
substrate	subsume	subterranean	subtext
subtle	subtlety	subtly	subtract
suburbia	subversive	subvert	succeeding
succession	successive	successor	succinct
succulent	sucker	suction	suede
suffering	suffice	suffocate	suffrage
suffuse	suggestive	suicidal	suite
suitor	sulfur	sulk	sullen
sully	sultan	sultry	summarily
summation	summon	sumptuous	sunburn
sundown	sunken	sunlit	sunscreen
sunspot	sup	superb	superconducting
superficial	superficiality	superfluous	superimpose
superintendent	superior	superiority	supernova
superpower	supersede	superstition	superstitious
supervisory	supplant	supple	supplement
supplemental	supplementary	supposedly	supposition
suppress	supremacist	supremacy	surcharge
surf	surfer	surge	surgical
surly	surmise	surmount	surname
surplus	surreal	surreptitious	surrogate
surveyor	susceptibility	susceptible	suspect
suspenders	suspense	suspicion	suspicious
sustain	sustainable	sustainablity	sustenance
swab	swag	swagger	swamp
swap	swarm	swastika	swat
swath	sway	sweatshirt	sweatshop
Swede	sweeping	sweetener	swell
swelling	sweltering	swerve	swig
swimsuit	swine	swinging	swipe
swirl	swish	switching	swivel
swollen	swoon	swoop	swordfish
syllable	syllabus	symbiotic	symbolical
symbolism	symbolize	symmetry	sympathetic
symposium	symptom	symptomatic	synagogue
sync	synchronize	syndicate	syndicated
syndrome	synergy	synonym	synonymous
synopsis	synthesis	synthesize	synthesizer
synthetic	syphilis	Syrian	syringe
syrup	systemic	tab	tableau
tablet	tabletop	tabloid	taboo
tabulate	tacit	tack	tackle
tacky	tact	tactic	tactile
tad	tailback	tailor	tailored
taint	talkative	tally	talon
tamale	tame	tamper	tan
tandem	tangible	tangle	tangled
tango	tangy	tantalize	tantalizing
tantamount	tantrum	taper	tapestry
tar	tarmac	tarnish	tarp
tarragon	tart	Taser	tasteful
tasteless	tatter	tattered	taunt
taut	tavern	tawny	taxable
taxation	tax-exempt	taxing	taxonomy
taxpayer	teak	teakettle	tease
teasing	technicality	technician	tedious
tee	teem	teeming	teeter
telecast	telecom	telecommunication	televise
teller	telling	telltale	temp
temper	temperament	temperate	tempo
temporal	temporarily	tempt	temptation
tempting	tenable	tenacious	tenacity
tenant	tenderloin	tendon	tenet
tenor	tense	tentacle	tentative
tenuous	tenure	tenured	tepid
tequila	terminal	termite	tern
terrace	terra-cotta	terrain	terrestrial
terrier	territorial	terrorize	terse
tertiary	testament	testicle	testimonial
testimony	testosterone	tether	textual
textured	thaw	theatrical	theft
thematic	theologian	theological	theology
theorem	theoretically	theorist	theorize
therapeutic	thereafter	therein	thereof
thermal	thermometer	thermos	thermostat
thesis	thicket	thistle	thong
thorn	thorny	thorough	thoroughfare
thoughtful	thoughtfully	thrash	thread
threadbare	three-pointer	three-story	threshold
thrift	thrilled	thriller	thrilling
thrive	thriving	throb	throes
throne	throng	throttle	throughout
throwback	thrush	thrust	thud
thug	thump	thunder	thunderous
thunderstorm	thus	thwart	thyme
thyroid	Tibetan	tic	tick
ticker	tickle	tidal	tidbit
tighten	tightness	tightrope	tights
tilt	timber	timbre	time-consuming
time-honored	timeless	timely	timetable
timid	tin	tinge	tingle
tinker	tint	tinted	tiptoe
tirade	tire	tireless	tiresome
tit	titanic	titanium	toad
toast	toaster	toddle	toddler
to-do	tofu	toil	token
tolerance	tolerant	tolerate	toll
toll-free	tombstone	tome	tomography
tonal	tongs	tonic	toot
toothpick	top-down	topless	top-notch
topography	topple	top-rated	topsoil
torment	tornado	torpedo	torque
torso	tort	tortilla	toss
tot	totalitarian	totality	tote
totem	touchdown	touchstone	touchy
toughen	tourism	tournament	tout
tow	towering	townhouse	township
toxicity	toxin	tracer	tracker
tract	traction	trademark	trade-off
trafficker	trafficking	tragic	tragical
trailhead	trainee	trait	trajectory
tram	tramp	trample	trance
tranquil	tranquillizer	transatlantic	transcend
transcendence	transcendent	transcendental	transcribe
transcript	transcription	transducer	transfix
transformative	transfuse	transgress	transient
transistor	transit	transitional	transitory
translucent	transmitter	transnational	transom
transparency	transpire	transplant	transplantation
trappings	traumatize	travail	traverse
travesty	trawl	trawler	tray
treacherous	treachery	tread	treadmill
treason	treasurer	treasury	treatable
treatise	tree-lined	treetop	trek
tremble	tremor	trench	trendy
trepid	trespass	triad	triangular
triathlon	tribal	tribesman	tribulation
tribunal	tributary	tribute	trickle
trickster	tricky	tried	trilogy
trimester	trimming	trinket	trio
triplet	tripod	triumph	triumphant
trivia	trivial	trivialize	troll
trolley	trooper	trope	trophy
tropics	trot	trough	troupe
trout	truce	trucker	truckload
trudge	truf	truffle	trump
trumpet	trustee	trusting	trustworthy
trusty	truthful	tryout	tsunami
tub	tube	tuber	tuberculosis
tubing	tubular	tuft	tug
tuition	tulip	tumble	tumbler
tummy	tumult	tumultuous	tundra
tune	tunic	tuning	turban
turbine	turbulence	turbulent	turmoil
turnaround	turnip	turnout	turnover
turntable	turpentine	turquoise	turtleneck
tusk	tutelage	tutor	tutoring
tuxedo	tweak	tweed	twelfth
twig	twilight	twine	twinge
twirl	twitch	twofold	two-story
tycoon	typify	typology	tyranny
ubiquitous	ugh	ulcer	ultimatum
ultra	ultrasound	ultraviolet	umbilical
umpire	unabashed	unaccustomed	unambiguous
unanimously	unanticipated	unassuming	unattended
unavailable	unbeaten	unbiased	unbridle
unbutton	uncanny	unchallenged	uncharacteristic
uncharted	uncompromising	unconscionable	unconscious
unconsciously	unconstitutional	uncontrollable	unconventional
undaunted	undeniably	underbrush	underclass
undercover	undercurrent	undercut	underdog
underfoot	underfunded	undergo	underlie
underline	underlying	undermine	underpin
underscore	undersecretary	understandable	understate
undertaking	undertone	undervalue	underway
underworld	underwrite	underwriter	undeserved
undeterred	undue	undulate	unduly
unearth	unease	uneasy	unethical
uneven	unevenly	unfaithful	unfavorable
unfettered	unforgiving	unfulfilled	unfurl
unholy	unhook	unification	uniformity
uniformly	unify	unilateral	uninformed
uninsured	unintended	unintentional	unionized
uniquely	uniqueness	unison	unitary
unite	unjust	unknowingly	unlawful
unleash	unmanned	unmarked	unmistakable
unnerve	unoccupied	unorthodox	unparalleled
unplug	unprecedented	unpredictable	unpretentious
unravel	unrealistic	unregulated	unrelenting
unremarkable	unresponsive	unrest	unruly
unsavory	unscrew	unseat	unsolicited
unspeakable	unsuspecting	unsweetened	untangle
untapped	unthinkable	unto	untouched
untreated	unveil	unwanted	unwavering
unwieldy	unwind	unwitting	unwittingly
unwrap	unyielding	upbringing	upcoming
up-front	upheaval	uphill	uphold
upholster	upholstery	upkeep	upland
uplift	upright	uprising	uproar
uproot	upscale	upshot	upstart
upstate	upstream	uptake	uptight
upturned	urbanization	urchin	urge
urinary	urinate	urn	usable
usefulness	usher	usurp	utensil
uterine	uterus	utilitarian	utility
utilization	utilize	utmost	utopia
utopian	utter	utterance	vacancy
vacant	vacate	vacationer	vaccinate
vaccum	vacuum	vaginal	vague
vain	valet	valiant	validity
valor	value-added	vampire	vandal
vandalize	vanguard	vanilla	vanity
vanquish	vantage	vapor	vaporize
variability	variant	variation	varied
variegate	varsity	vascular	vase
vat	vault	veal	veer
vegan	vegetation	veggie	vehement
veil	vein	velocity	velvet
vend	veneer	venerable	Venetian
Venezuela	vengeance	vengeful	venison
venom	venous	vent	ventilator
venture	venue	veracity	veranda
verbal	verdant	verdict	verge
verification	veritable	verity	vernacular
versatility	verse	versus	vertebra
vertebrate	vertigo	vested	vestibule
vestige	vet	veteran	veterinarian
veterinary	veto	vex	viability
viable	vial	vibe	vibrant
vicinity	vicious	viciously	victimize
victor	victorious	vie	vigil
vigilance	vigilant	vigilante	vigor
vigorous	vilify	villa	villain
vinaigrette	vindicate	vindictive	vineyard
vintage	vinyl	violator	violet
viral	virginity	virtue	virtuoso
virtuous	virulent	visage	vis-à-vis
visceral	visionary	visor	vista
vital	vitality	vivid	vocalist
vocational	vogue	void	volatile
volatility	volcanic	vole	volley
voltage	voluminous	voluntary	vomit
voodoo	voracious	vortex	vouch
voucher	vow	vowel	vulgar
vulnerability	vulnerable	wacky	wad
waddle	wafer	waffle	waft
wage	wager	wail	waistband
waive	waiver	wake-up	walkie-talkie
walk-in	wallow	walnut	wan
wander	wane	wannabe	wanting
wanton	ward	warden	wares
warhead	warlord	warp	warped
warplane	warrant	warranty	warring
wart	war-torn	wary	washcloth
wasp	wasteland	watchdog	watchful
waterfowl	waterfront	waterway	watery
waver	wavy	wax	wayside
wayward	wean	weaponry	wearer
weary	weathered	weave	weaver
wedge	wedlock	wee	weekday
weep	weeping	weighted	weightless
weld	welder	welfare	well-being
well-documented	well-established	well-intentioned	well-meaning
wellness	well-off	well-rounded	well-to-do
well-worn	whack	whaling	wham
wharf	whatsoever	wheelbarrow	wheeze
whence	whereabouts	whereby	whereupon
whim	whimper	whimsical	whine
whip	whir	whirl	whirlpool
whirlwind	whisk	whisker	whisper
whistle-blower	whistling	whitetail	whittle
whiz	whizz	wholesale	wholesaler
wholesome	wholly	whoop	whop
whopping	wicked	wicker	wide-eyed
wide-open	widowed	wield	wiener
wiggle	willful	willingly	willingness
willow	wilt	wily	wimp
wince	windbreaker	windfall	winding
windmill	windowsill	windswept	winery
winged	wink	win-win	wiper
wired	wiretap	wiring	wiry
wishful	wisp	wispy	wistful
wit	witchcraft	wither	withhold
withholding	withstand	witness	witting
witty	wobble	woe	woefully
womanhood	womb	woo	wooded
woodland	woodpecker	woodwork	woolen
woolly	wording	workable	workbench
workforce	workhorse	working-class	worksheet
worldview	worn	worn-out	worrisome
worsen	worship	worshiper	worst-case
worthwhile	worthy	would-be	wrack
wrangle	wrapping	wrath	wreak
wreath	wreck	wreckage	wrench
wrest	wrestle	wrestler	wretch
wretched	wriggle	wring	wrinkle
writ	writhe	wrongdoing	wrought-iron
wry	yacht	yam	yank
yardage	yardstick	yarn	yawn
yearbook	yearly	yearn	yeast
yelp	yen	yer	yield
yoke	yolk	youthful	yuppie
zap	zeal	zealot	zealous
zenith	zest	zigzag	Zionist
zip	zoom	zucchini	